10 10
0001110011
1100000100
0001110001
0110000111
0000011111
1100000000
0000111000
1100000010
0000111000
0001000011